NO ./textures/wood.xpm
SO ./textures/wood.xpm
WE ./textures/wood.xpm
EA ./textures/wood.xpm

F 220,100,0
C 225,30,0

11111111111111111111111111111111111111111111111
11110000000001111110000000000000000000000001011
11000000001000000000010000000000000010000000001
 1000000000010000000000010000000000000000010001
11000000000000000E00000000100000000000010000001
11110000110001111000011111110100000000000011101
11000001101111111111111111111111111000000000011
10000011100010000010001000000100010011111111111
1000001111010000000100000100000000000010000011
1100000111100000001000011000000000000100000011
1110000001100000110000011111111000000110000011
1100000001110000111111100000000000000011111111
100000000000000011111111000000000111111111111
100000000000000000000000000000000000000000011
111111111111111111111111111111111111111111111
